18x12
##################
# A            #F#
# ##### ######## #
#     #       #  #
##### # # ###### #
#     # # #      #
# ##### # # #### #
#       # # #    #
######### # # ####
#         # #    #
#            #####
##################