12x8
############
# A#      F#
#  #####   #
#      #   #
#### # # ###
#    # #   #
#        # #
############