10x7 
##########
# A     ##
#   ####F#
#   #    #
## ## ####
#        #
##########